Acetobacter_aceti	Ferment
Acetobacter_ascendens	Ferment
Acetobacter_cerevisiae	Ferment
Acetobacter_cibinongensis	Plant
Acetobacter_conturbans	Ferment
Acetobacter_estunensis	Ferment
Acetobacter_fabarum	Ferment
Acetobacter_fallax	Ferment
Acetobacter_farinalis	Ferment
Acetobacter_garciniae	Ferment
Acetobacter_ghanensis	Ferment
Acetobacter_indonesiensis	Plant
Acetobacter_lambici	Ferment
Acetobacter_lovaniensis	Plant
Acetobacter_malorum	Ferment
Acetobacter_musti	Ferment
Acetobacter_nitrogenifigens	Ferment
Acetobacter_oeni	Ferment
Acetobacter_okinawensis	Plant
Acetobacter_orientalis	Plant
Acetobacter_orleanensis	Ferment
Acetobacter_oryzifermentans	Fly
Acetobacter_oryzoeni	Ferment
Acetobacter_papayae	Plant
Acetobacter_pasteurianus	Ferment
Acetobacter_peroxydans	Plant
Acetobacter_persici	Fly
Acetobacter_pomorum	Fly
Acetobacter_sacchari	Plant
Acetobacter_senegalensis	Ferment
Acetobacter_sicerae	Ferment
Acetobacter_syzygii	Ferment
Acetobacter_suratthaniensis	Plant
Acetobacter_thailandicus	Plant
Acetobacter_tropicalis	Fly
Acetobacter_vaccinii	Plant
Acetobacteraceae_bacterium_ESL0697	Insect
Acidocella_aromatica	Acidophilic
Acidomonas_methanolica	Ferment
Ameyamaea_chiangmaiensis	Plant
Aristophania_vespae	Insect
Asaia_astilbis	Plant
Asaia_bogorensis	Plant
Asaia_krungthepensis	Plant
Asaia_lannensis	Plant
Asaia_platycodi	Plant
Asaia_siamensis	Plant
Asaia_spathodeae	Plant
Bombella_apis	Insect
Bombella_dulcis	Insect
Bombella_favorum	Insect
Bombella_intestini	Insect
Bombella_mellum	Insect
Bombella_pluederhausensis	Insect
Bombella_pollinis	Insect
Bombella_saccharophila	Insect
Bombella_sp	Insect
Commensalibacter_communis	Insect
Commensalibacter_intestini	Fly
Commensalibacter_melissae	Insect
Commensalibacter_papalotli	Insect
Endobacter_medicaginis	Plant
Entomobacter_blattae	Insect
Formicincola_oecophyllae	Insect
Gluconacetobacter_aggeris	Plant
Gluconacetobacter_asukensis	Plant
Gluconacetobacter_azotocaptans	Plant
Gluconacetobacter_diazotrophicus	Plant
Gluconacetobacter_dulcium	Plant
Gluconacetobacter_entanii	Ferment
Gluconacetobacter_johannae	Plant
Gluconacetobacter_liquefaciens	Plant
Gluconacetobacter_sacchari	Plant
Gluconacetobacter_takamatsuzukensis	Plant
Gluconacetobacter_tumulicola	Plant
Gluconacetobacter_tumulisoli	Plant
Gluconobacter_aidae	Plant
Gluconobacter_albidus	Plant
Gluconobacter_cadivus	Plant
Gluconobacter_cerinus	Fly
Gluconobacter_frateurii	Plant
Gluconobacter_japonicus	Ferment
Gluconobacter_cerevisiae	Ferment
Gluconobacter_kanchanaburiensis	Plant
Gluconobacter_kondonii	Plant
Gluconobacter_morbifer	Fly
Gluconobacter_oxydans	Industrial_ferment
Gluconobacter_potus	Ferment
Gluconobacter_roseus	Plant
Gluconobacter_sphaericus	Plant
Gluconobacter_thailandicus	Plant
Gluconobacter_vitians	Ferment
Gluconobacter_wancherniae	Plant
Granulibacter_bethesdensis	Human_disease
Komagataeibacter_diospyri	Plant
Komagataeibacter_europaeus	Ferment
Komagataeibacter_intermedius	Ferment
Komagataeibacter_kakiaceti	Ferment
Komagataeibacter_medellinensis	Plant
Komagataeibacter_melomenusus	Ferment
Komagataeibacter_nataicola	Ferment
Komagataeibacter_oboediens	Ferment
Komagataeibacter_rhaeticus	Ferment
Komagataeibacter_saccharivorans	Plant
Komagataeibacter_sucrofermentans	Plant
Komagataeibacter_swingsii	Plant
Komagataeibacter_xylinus	Industrial_ferment
Kozakia_baliensis	Plant
Lichenicoccus_roseus	Plant
Lichenicola_cladoniae	Plant
Neoasaia_chiangmaiensis	Plant
Neokomagataea_anthophila	Plant
Neokomagataea_tanensis	Plant
Neokomagataea_thailandica	Plant
Nguyenibacter_vanlangensis	Plant
Novacetimonas_cocois	Plant
Novacetimonas_hansenii	Ferment
Novacetimonas_maltaceti	Ferment
Novacetimonas_pomaceti	Industrial_ferment
Oecophyllibacter_saccharovorans	Insect
Parasaccharibacter_apium	Insect
Roseomonas_mucosa	Acidophilic
Saccharibacter_floricola	Plant
Saccharibacter_sp	Insect
Swaminathania_salitolerans	Plant
Swingsia_samuiensis	Plant
Tanticharoenia_sakaeratensis	Plant
Acetobacter_sp	Ferment
Asaia_sp	Insect
Commensalibacter_sp	Insect
Gluconobacter_sp	Fly
Komagataeibacter_sp	Ferment
Lichenicoccus_sp	Plant
Nguyenibacter_sp	Plant
